#########
#.......###
#....###@.##
#.##....o...#
#.......##.##
#x.#........#
#############