###################
####x.............#
###########..###..#
#........##.#######
#....0...##.#
#.#########.#
#............#
#.....#.......#
#....##........###########
#.....#................###
#......@#########O.....###
#x.....................###
##########################