#############
#.......#####
#....###@.###
#.##....o...#
#.......##.##
#x.#........#
#############